NO ../textures/prototype_red.xpm
SO ../textures/prototype_blue.xpm
WE ../textures/prototype_yellow.xpm
EA ../textures/prototype_green.xpm

C 0,0,0

            1111111111111111111111111
            1000000000110000001100001
            1011000001110000011S00001
            1001000000000001001011111
111111111111100001110000001110001
100000000011000001110111111111111
11110111111111011100000010001
11110111111111011101010010001
11000000110101011100000010001
10000000000000001100000010001
10000000000000001101010010001
11000001110101011111011100111
11110111 1110101 101111010001
11111111 1111111 111111111111

F 194,194,194
