                                                        SO          ./path_to_the_south_texture
            WE                  ./path_to_the_west_texture

            F                  255,100,1



   NO                  ./path_to_the_north_texture

    C               12,12,255


 EA                          ./path_to_the_east_texture

            1111111111111111111111111
            1000000000110000001111111
            1011000001110000011N00001
            1001000000000001001111111
111111111111100001110000001110001
100000000011000001110111111111111
11110111111111011100000010001
11110111111111011101010010001
11000000110101011100000010001
10000000000000001100000010001
10000000000000001101010010001
11000001110101011111011100111
11110111 1110101 101111010001
11111111 1111111 111111111111
