111111
100101
101001
1100O1
111111