WE ../../textures/w3d_wall_blue.xpm
NO ../../textures/w3d_wall_blue.xpm
SO ../../textures/w3d_wall_blue.xpm
EA ../../textures/w3d_wall_blue.xpm
D ../../textures/w3d_door_l.xpm
F 131,131,131
C 0,0,131

1111111111111
1000000000001
1011011011011
1D0D1D0D1D0D1
1011011011011
1000D00000D001
1011011011011
1D0D1D0D1D0D1
1011011011011
1000000D000001
1011011011011
1D0D1D0D1D0D1
1011011011011
1000D000E0D001
1111111111111
